
NO ./textures/1.xpm 
SO ./textures/2.xpm
WE ./textures/3.xpm
EA ./textures/4.xpm 


F 92, 80 ,51
C 135, 206, 235

11111111111111111111111111111111
10000000000000000000000000000001
10001111100111111111100111110001
10001000000000000000000000010001     11111111
10000000101010101010101000000001     10010001
10000000000000000000000000000001     10000001
100000110001111111111100110000011111110000101
100000100000000000000000010000000000000010001
100000000E00000000000000000000000000000000001
100000000000111111110000000000011111110010001
1000001000001      1000001000001     10000101
1000001000001      1000001000001     10000001
10000000000011111111000000000001     11100111
10000000000000000000000000000001       1001
10000010000000000000000001000001       1001
10000011000111111111110011000001       1001
10000000000000000000000000000001       1001
10000000101010101010101000000001       1001
10001000000000000000000000010001       1001
10001111100111111111100111110001       1001
10000000000000000000000000000001       1001
11111111111111001111111111111111       1001
             1001                      1001
             1001                      1001
             1001                      1001
             100111111111111111111111111001
             100000000000000000000000000001
             111111111111111111111111111111