
NO ./textures/1.xpm 
SO ./textures/2.xpm
WE ./textures/3.xpm
EA ./textures/4.xpm 


F 92, 80, 51
C 135, 206, 235



111111111111111111111111
100000000000000000000001
100000000000000000000001
100000000N00000000000001
100000000000000000000001
100000000000000000000001
100000000000000000000001
100000111110000101010001
100000100010000000000001
100000100010000100010001
100000100010000000000001
100000111000001010100001
100000000000000000000001
100000000001000000000001
100000000001000000000001
111111111111000000000001
100000000000000000000001
100000000000000000000001
100000000000011111111111
111111111000000000000001
100100001000000000000001
100000101000000000000001
100100001000000000000001
100111111000000000000001
100000000000000000000001
100000000000000000000001
111111111111111111111111